111111111111111111111111111111111111
100000000000000001000000000F00000001
10C010000000000001000F0100000F000001
10001000000000000100F001000000000C01
1000100000000000010F0001000001000001
1P0010F00F00F000000000010F00010F0001
111111111111111100011111111111111111
1000100C000100000F000001000000000001
100010000F010000000000010000E0C00001
100010F00001000001001111111111110F01
10001000000100000100C00F000F00C00001
1000000000000C0001000F000F000F000001
111111111111111111111111111111111111
