1111111111111111111111111111111111111111111111111111111111111111111111111111111111111111111111111
1E0000000000000000C00000C0000000000000C00000C0000000000000C00000C0000000000000C00000C000000000001
1010010000100100000101001000001001000001010010000010010000010100100000100100000101001000000010101
1010010000010101010001001000000101010100010010000001010101000100100000010101010001001000000010101
1P0000000000C00C0000000000000000C00C0000000000000000C00C0000000000000000C00C0000000000000000000C1
1000000000000000000000000000000000000000000000000000000000000000000000000000000000000000000000001
1000000000000000000000000000000000000000000000000000000000000000000000000000000000000000000000001
1000000000000000000000000000000000000000000000000000000000000000000000000000000000000000000000001
1000000000000000000000000000000000000000000000000000000000000000000000000000000000000000000000001
1000000000000000000000000000000000000000000000000000000000000000000000000000000000000000000000001
1000000000000000000000000000000000000000000000000000000000000000000000000000000000000000000000001
1000000000000000000000000000000000000000000000000000000000000000000000000000000000000000000000001
1000000000000000000000000000000000000000000000000000000000000000000000000000000000000000000000001
1000000000000000000000000000000000000000000000000000000000000000000000000000000000000000000000001
1000000000000000000000000000000000000000000000000000000000000000000000000000000000000000000000001
1000000000000000000000000000000000000000000000000000000000000000000000000000000000000000000000001
1000000000000000000000000000000000000000000000000000000000000000000000000000000000000000000000001
1000000000000000000000000000000000000000000000000000000000000000000000000000000000000000000000001
1000000000000000000000000000000000000CCCCCCCCCCCCCCCCCCCC0000000000000000000000000000000000000001
1000000000000000000000000000000000000CCCCCCCCCCCCCCCCCCCC0000000000000000000000000000000000000001
1000000000000000000000000000000000000CCCCCCCCCCCCCCCCCCCC0000000000000000000000000000000000000001
1000000000000000000000000000000000000CCCCCCCCCCCCCCCCCCCC0000000000000000000000000000000000000001
1000000000000000000000000000000000000CCCCCCCCCCCCCCCCCCCC0000000000000000000000000000000000000001
1000000000000000000000000000000000000CCCCCCCCCCCCCCCCCCCC0000000000000000000000000000000000000001
1000000000000000000000000000000000000CCCCCCCCCCCCCCCCCCCC0000000000000000000000000000000000000001
1000000000000000000000000000000000000CCCCCCCCCCCCCCCCCCCC0000000000000000000000000000000000000001
1000000000000000000000000000000000000CCCCCCCCCCCCCCCCCCCC0000000000000000000000000000000000000001
1000000000000000000000000000000000000CCCCCCCCCCCCCCCCCCCC0000000000000000000000000000000000000001
1000000000000000000000000000000000000CCCCCCCCCCCCCCCCCCCC0000000000000000000000000000000000000001
1000000000000000000000000000000000000000000000000000000000000000000000000000000000000000000000001
1000000000000000000000000000000000000000000000000000000000000000000000000000000000000000000000001
1000000000000000000000000000000000000000000000000000000000000000000000000000000000000000000000001
1000000000000000000000000000000000000000000000000000000000000000000000000000000000000000000000001
1000000000000000000000000000000000000000000000000000000000000000000000000000000000000000000000001
1000000000000000000000000000000000000000000000000000000000000000000000000000000000000000000000001
1000000000000000000000000000000000000000000000000000000000000000000000000000000000000000000000001
1000000000000000000000000000000000000000000000000000000000000000000000000000000000000000000000001
1000000000000000000000000000000000000000000000000000000000000000000000000000000000000000000000001
1000000000000000000000000000000000000000000000000000000000000000000000000000000000000000000000001
1000000000000000000000111111111111100000000000000000000000000000000000000000000000000000000000001
1000000000000000000000111111111111100000000000000000000000000000000000000000000000000000000000001
1000000000000000000000111111111111100000000000000000000000000000000000000000000000000000000000001
1000000000000000000000111111111111100000000000000000000000000000000000000000000000000000000000001
1000000000000000000000111111111111100000000000000000000000000000000000000000000000000000000000001
1000000000000000000000111111111111100000000000000000000000000000000000000000000000000000000000001
1000000000000000000000111111111111100000000000000000000000000000000000000000000000000000000000001
1000000000000000000000111111111111100000000000000000000000000000000000000000000000000000000000001
1000000000000000000000111111111111100000000000000000000000000000000000000000000000000000000000001
1000000000000000000000111111111111100000000000000000000000000000000000000000000000000000000000001
1000000000000000000000000000000000000000000000000000000000000000000000000000000000000000000000001
1000000000000000000000000000000000000000000000000000000000000000000000000000000000000000000000001
1000000000000000000000000000000000000000000000000000000000000000000000000000000000000000000000001
1000000000000000000000000000000000000000000000000000000000000000000000000000000000000000000000001
1000000000000000000000000000000000000000000000000000000000000000000000000000000000000000000000001
1000000000000000000000000000000000000000000000000000000000000000000000000000000000000000000000001
1000000000000000000000000000000000000000000000000000000000000000000000000000000000000000000000001
1000000000000000000000000000000000000000000000000000000000000000000000000000000000000000000000001
1000000000000000000000000000000000000000000000000000000000000000000000000000000000000000000000001
1000000000000000000000000000000000000000000000000000000000000000000000000000000000000000000000001
1000000000000000000000000000000000000000000000000000000000000000000000000000000000000000000000001
1000000000000000000000000000000000000000000000000000000000000000000000000000000000000000000000001
1000000000000000000000000000000000000000000000000000000000000000000000000000000000000000000000001
1111111111111111111111111111111111111111111111111111111111111111111111111111111111111111111111111
