111111111111111111111111111111111
100000000000000000000000000000001
100000000000000000000000000000001
10000P00000000000000000000000E001
100000000000000000000000000000001
10000000000000000000CCCCCCCC00001
100000000000000000000000000000001
100000000000000000000000000000001
100000000000000000000000000000001
100000000000000000000000000000001
111111111111111111111111111111111
