1111111111111
10000000V0001
10P0CCCE0C001
100000F000001
1111111111111
