111111111111
100000000001
10P000000E01
100000000001
111111111111
