111111111111
100000000001
100000C00E01
100000000001
111111111111
