111111111111
100000000001
10P000C00001
100000000001
111111111111
