111111111111111111
100000000000000001
100000000000000001
10P0000CCC0000E001
100000000000000001
100000000000000001
111111111111101111
