111111111111111111111111111111111
1P01000000000000001C00000000011E1
100110001111111100000000000000101
1011C0001000000011110010000011101
101001001000000010001010000000001
100111111000000010101010000011111
100000000000000000100010000010C01
100000000000000000000000000010001
100101101011000110000000011110001
100000001010000010000000001000001
100011100000111000001001000100001
100000000000111010011101101100001
100000000000111010000001000100001
100000000000000010000000000010001
100000000000000000000000000000001
111111111111111111111111111111111
