111111111
1P0C000E1
111111111
