11111111111111
1PE10000000001
10C1000FF00001
10000000000001
11111111111111
