111111111111111111111111111111111111111111111111111111111111111111111111111111111111111111111111111111111111111111111111111111111111111111111111111111
1C0F010C0000C010CC00C010CC0001000P000CC00100000C010011100C110C0C001100C0001C01C000000C0C00C000C01C00C1C110C0000C10C100001CC1CC11C0001100C0C00010CCC001
10000C00C001C10100CCC1001CC1101101CC00C0001C100110010000C0CCC00CC0000000100000000000CC0C1010001000C00C00100CCCC1010001001C1C00C00C00C0010100010C1CCC01
100100000C1100CC0C00C0010C0101CCC0CC0001010CC1000C101C0C00010CC0CC011C0C000CC1111001000C1000000C00C0CCC000010C01000010000C0C101000CCC000000CC000000001
10000C1000C00110010C0C00CC00C1011C00C000100CC0C0011000C00C0C10C10CCCC10000C001CC0110001100C1CC011C101010C0000000000100C1000C110C00C0100C0C000CC1001001
11C0010C0C0000001C01000100011C0CC0100000C000C00000C101C000C110000C001C1000C0100CCC11000C111011000110C0001C00C011100C100110C10CC00000C0100C000C00100011
10111000001111000000C101CCC010000C00000101C00010100C010C000C0100C0C100100C010000CCC00000C000000C00011C0C00100C00C0C100000C011C001000CC010C00C10001C001
100C1000C0C00CCCC0C1011C001010C10C1CCC010011010C0C00C01010C10000101110C0000C0CC1001101000001001CC00000C00C100110C0000100011100C1000C000000000C010CC011
1110CCC0010000000C00CC1CCC0000010C0C0001000CC1C1001C1110010C00C1010001101C1C011100C010001C000C100000C1110C00000C0000C00000110CCC0C0CC000100C0101101001
11CC1001C0CC01C001001100C1C10000000C0C00000000CC00C0011C00C10C1000000101000C0C01000C00010C011CCC100100000C0100C001C01000C0000C000001C00010CCC001011001
11C00001C1C0100C010C0000C0001C10C1C0C1C001C0001C100C0011000C0C1C1C0C1C0C1C110CCC00010100CCC000C010C100CC01100010100000C0000010C00001C1C0C11CC0C01CC001
1C000010C0010C00CCC1CC0000C0C10C1100000C00001C01C100100CC000CC0CC00C0C11C00C0000000C011001000000CCC01CC0CC0CCC00CC0C0001C0000C11001011CCCC0C0000001001
110C010100C00C0C0C00C1CC00C1010C00CC11C0100C1011C100C010001C00CC0000100C111110C01000000000C0CCC0000C00000C0CC100001C110C1010CC00C00000100CC0C000000101
1111000C0100000010010C1C010C00C0011C000100C010C10C10000000010C000C010C0C0110CC0000C0CCC001C000110000100C0C10001C110C00000C10C00C0010CC000C000C110C0101
1C00001000CCC11C00110011001C1C0001C0001001C000C100CC10100000011000000100C00100C0CC00C0C0C010C0CC010C00010100C001C000000C00CC100000C100000000C100000011
1C01C101C010001000010000001000C000CCC00C0C0C00101000C0C0CC00000C000C00000C0001000CCC0000000C1000100000000C01C0CCC11C0101C1000010011000000C00001C0C0001
1010000000000100000101CC1000001C0CC1C0C00C000110C00000000101C000CCC1010C010C000C00001101000C0C0C1CCC001C1100000100000000C00101010C011C00C010C10CC00111
100011010CCC000C0C000010CC1000000C100C11C11C00C1000C0C010C10C00C001000010C0000010000CC0CC1C0000000010C0111000CC000C000000001CCC00100C000C00000C110C011
10101100CCC1C00000C000000C11100CC0100011000C00000C0CC00111000CC1C00000CCCC1CC0CC0C00CCC1CC0C0000110CC01000000CC0C0001C10C111001000000C010CC00C00C10001
10C10000C0CCC111C0001CC000100C001001C1CCC0CC0001010C0000110C10C11CC0CCCCC00110C00C00000000C100100C0C0C1000C0000C0C00C111000000000000000C000C10010C0C01
1C0C100100C0010C100C00C01C1100010000001000CC001001C10010100C10000000C0110C000010010CC0000000C10000CC000100CC000CC0C0CC001C10001001C00C0C0000000C1C0001
101000010000C1C00011101100C00C00CC0CCC01CC000001010C0100C1CC100010C0CC0C10C000C0CCC000001CC01000010001000000CC0C101C0001CC00000001000CC0010100C0000CC1
10C0000010C1100C10CC01C10C0C00C11C011000000C0000C0000101C01C010C00001CC0C000CC1010000C00C0C10C0000C000100CCCC0001CC0C10001C000000C0000CC00C0010CC000C1
1C001CC00C10C00000100000000001CC0C0C0C0C101CCC0110000000C000CCC0001C100C1C0001C1C000CC00C1100100000000C0010001C1CC00CC10C10001C0000000110C0C1C00001011
1000CC010000CC1000000C00011C0C00CCCC0C110C1C1CCC01001C1000000C010000010000000CC0C0101C101101111C001C0C010000010C01100C01C001CC0C10C0100010000100C10C01
100C01CC0C000C001100001C110C010C0001000C0000C00101CC01010C000C10000C0000C110000C11C0100000001CC01100C0C100C100011100101C001000100000CC1C0001C00CC00C01
100001C1000010C00CC0C0C101001C001000C0CC000C00C0C000000010C000C000C0C1C000C10C000CC0C0C001010010C00010CC000001CC0000CC001C00000C0C000C0C00C0000C00CC01
100100001C110C0CCCCC0010011C00CC001CC0C0C1000C1000C0000C0C001CCC01CC0001010CC1100C0111C0101000000CC0C01CC00CC010C00000C0C00000C000000001C0C000C000C001
10100100C10CC01C1C01CC10100C100C10000C01CC1C10000C10100C10100CC1000000C10001CC1001000000C0010C100001001C0000C0000C0000C00C00010000100000C0C101C000C0C1
10C0CCCC00C10C0C0C00C0001110C1000C01CC0100100C10C1100C0CCC000001C01000111011000100C1011000C00001C0001C0000C0001001C0C0C000100000000000010CC00CC1C000C1
101000CCC00010000C0000C1000C1CC000001010C00C00C0CC0001C101000C000100C0C1C0C000C0C01C00010C1000000C0000010C0C000000C100010000110CC0C0010CC001001000CC01
1CC0C01000C01C0000C00100000C000100011C000010100CCC010001C11C000C0C000010CC0111C0C11C000110010000000C1001C0000C000C10CC011010001C001C0000C10C1100000001
100C0000110C00CCC1010C0010C0100CC00C10CC0100000CCC0C00CC000C101CE00011C00100001C000000C100C10100C00C1C00000C011C100101101010C101000000CC000CC10C000001
1C0C00000000CC010100000CC0C1C000C1C00C1C0C00C01000C0000C0C100001001CC0010000C01C10C0000CC1C100000000C0C0001C00C10000C010C00100C000000C000CC010CC101101
10C010C01000010C101000C000C0110010011C00000C1C000C10011C01C000000C0C1CC000C001000000CC00001C0C01C0C0C00000C001101001100100C00101C0100CC01C10C000001101
1CCC000C10100C001100001CC0000000C10101C00010010C000110C0C10000000101000C00C1010C00100C0CC0CC100C01100CCC000C00C00000001CC10CC100C00C110C00C010C0CC0101
10001100CCC0011010CC001000101C1CC0000000C00C11CC100C000111C01C0C00C0C00001C0C000CCC1CC100100C000C1C0C01CC10CC000C000CC1000C10000110C000C0CC010000C10C1
1C0C0000101CCC0000C001C00C0000000000000CCCC101000C001000C0C0000010CCCC0C0001000C1C000C0C111C00C0010001011100000101100C00000C0C1C011C000C01C10000C0C001
111C1100001CC00001C100000010010C10CC0001C00CCCCCC0000C0001C00CC1CC0C1C01C0011C1C00CC0000C01000100C100C0C00000000C1C101C101C00000CC0010CC00000C00C1C001
10000C1CCC0CC00C0000C00CC00CCC1C0C1C00CCCCC11C0C1100010100CCC10100110C010CCC1001100000010CC11100C1010100000C0000000C000CC01C0C0C01100100000C0000C0C1C1
1000000000C100C0C0000CC001C000C0C000CCC000CCC00001C0C0001C011110CC011FFCCC000C0C10C000C011C1100100010C0100C0C0C1C111C1C10C010001000000000CC0C0000CC1C1
100C1000C0100C1010000001C1C1000C1000C0C00C100C00C0000C000001000CC0000CC1C0C000C000000001C0010101C0C1100C000C0C00000000001CC0001C00CC0010000C0000C10101
1010010C00001110000000C0010C00CC0C100C01C10100C000C011C000100C00000000000101C110101C10000000000000001C01000C01110000C00C00C01000011001000000CCC1000001
1000C000010C00100000001000CCC0000000011C0C00C000100C1C0000C0CC000100C01C001100C010C1100C000C1C000110C0000000000100C00C0111000001000000C0000C0C00C000C1
1000C000C0C01C0C1C00CCC1100C1C1C0010CCC0C00100001000C00C0100C0C10CC00C1CC000C0C0C00C0C00100000C00C10111CC0110010000000010001C00C0011CC00000C00C00C0101
1011C00C100C100CC1CC00000C0C01000010100000C1C00101000C1010000000C0000C1C1C11100000010000100000C0100C0111C000C0001000000C010000010C110C00C000CC01010C01
11100001C01CC001100C100010000100000010C000C00C00CC0000C00C00000C0C1100C000C0C00001101C0001101C001000CCCCC00C000C0CCC000CC000C0CC10001C10000CC000010001
100001C0000C00CC11010C0000C0000110C10C1010C00C01001100CC100C0100C01C00000010C011010010C0C1110000000C0CCC1C000C000011110C00000100010C1000C0010C00000CC1
1101C00CC01000C00010C001110C01010101001000000110CC00CCC000C0CC00000CC000C1C10C010000000010011C0C0000C000CC0010CC000100C00000CC10C0CCC000C11000000C1101
1C0000C00100010C00000CCC001C010C0001CC0111C000C00C0CC000000000000C0000000C00C00100C00C0001C0CCC100010100C0C00CC0C10C00000CC01CC0C101000C00C101001C0001
1010001C0010110C0010C0C0000C0C000100001000000C0000000010100CCC01000C000CC000C0C00C01101CC000C10C00C101001C000010C000010000C000C1C11000001010110000C111
1C11C0011001000110101C0000010C0100C01C0110C0C00C00C000000CC00C1C00000000000C001CC100000CC00C0CC0C0C0101C000C1C0000C00111000C0CC100C00000C000C0010100C1
1C010010100000000C00C00CC00100C0C0C00C01C10001000010000100000001C010CCC01CC000010C001011C0C0000000100CCC001000C0101C0C01C1000110000000C000C100000000C1
11CC100CC01000C00C00CC0011C0C101C00CC00000000C00CC0C1C011C0000100000C0C01C00000C100C10001CCC0C000C10C10C1000010C00C0001000000CC00C00101CCC0CCCC0000C11
1C01C000C01C010000C1000C001C0CC0C010C00100C00C0C100C0C101C00000100000010000C0C0C000CC0C0CC0C0000100010CC0C101110C000000C00CC00C0CCC10C0CC00CC010C00001
1C00100000010CC0000001000000000C110C0000100C01C0100011100C0001C11C00CCCC0CC010000100C1000C001C01C00CC100C0CC0010001C01C1000001011001C000C0000C0C000101
1C00010010C00000010C1C0C100C1C00C00CC001000C00C01000000CC10C110100000C0C10C01CCC00001C001C0101C0C00CC0C00000100C00C00CC10010C1100000C00001100CC0101011
1C1CCC1C0C01000CC0CCC0101000CC0001000CC01001C1C0101010C110C0001C01111000C101CC100110111C0C00C10CC100C0C1C01C001C0001CC0000100CC000CC000CC010C01C00C0C1
1CC000C0C01000C0C0C0CC01000000000CC11010C01C100C100010100CC10C0000101CC0100C0C00100CC0CC0C000100CCC1CC1C001010CCC00000C0C00CCC00000110C10C0C1001C11001
1000000000011C001C00001C0100000C001000101000C100C010CC00000C1000000000C011C000C001C0CC0C01100C00C00C0100001C000011C00CC000CC00C0010CC1010001C000C1C011
1C001C10100CC0C000101000000010CC00C0000000C0C010000010C001C0C0C0000C1001001101C010001C01C0C001C1C001011C000000C000100C1000000010C000000C0100100C000C11
100C10C00100C00CC1000CC001C0000CC0C1110110101C1100CCC01C100000C01000011101C0001000000010000CC00C0CC000C0100C000C0100010C00C000010CC00CC0001000C0C00011
1000C000CC10C0100C00000C1101110CCC0010100011C1C00010C00C1000000CCC10010C1C10C0C0CC00CC11C0C001CCCCC00C000C10100C0C1C00CC00000100000010010CC00CC0C01001
1100000C1C10C10CC001000C0C0000C010000CC011C00CC00100C1C10CCC001000000001C0CC000C000C0C000101CCC1C10C01C0000000C0010010010C0CC1000CC0C00C100000100C0001
100C000C000000CC10000C000100C10001010010C10101CC0100000C10C000001CC0000011010C00000010C0101001C000101CC000000C10000C10100CC000C01100010C0CC0C10C0000C1
1101001110000100C11100C000000100100C0C110000C010C001101CCC0100C0C1000000001C10100C000C1000C10001001C0C01CC001001C000C11000100101100100C1C00C0001100001
1C0C0C01100CC10C0000C010111C110CC0C00C00000C00100C0C00100100010CC10000C110C000000000010C001000100001CCCCC00C0CC01C000C0000C01C0000010011000C1000000C01
100001101000C000C00100CC00010C00C00CCCC10100000C10010C000C110C00010C00000C00100001001110010010CCC00CC0C00010CC10001C1C100C10C00000000C00C01C0010100001
10C0C111C0010000CC00100CCC00C000000C00C0C00CC0000C0000C1000C0101C01C1010C0C000101C000C10C000C0CC00CC01001000C0C00C0C0C000C00110000C00CC0C1CC0C00C00001
100C00000001C00111CCC000C0001100C1CC10CC1000CC0000C1001C0000100C10100C0CC10000010001C000010C01C10CC0CCC00000C00010C01C00100C0C10C0CCC11CCCC1000C100001
101C01100010C0C1000C0010101000100C0C110C1111000C11C000C010000001C0C01010C00CC0CCCC01C0000C000000C10C1C00C0000000C00000100101000110C11C0C100CCCC0011101
1000000C0C10100100CC10C0C000C0C00C0C011100C001000000CC0C0C01C000010C0C0100000C000000C000C100000000CCC00000C101C01C10000101CCC0000000000100C00C0C000011
11100100C00001C01C100C00C000CC100C100000100C001100000C100100CC00C01CCC01011001C0C0C00C0C1001000C0C0C000100C1100000CCC00C0C1011C010000000C00001C00C0C01
1C0101C10CC0C010C000CC0C00001C1C000000C0000000C0110C0C1C0C110000C101000C0000CC11C01C100CC000000C0C0C10100100C010C010CC01001CCC00C000000C00010000000111
11001100000CC0C00CCC0C0010C0C1001000C0010000000C100C0C011101C00C010001001C0C00000011C0CCC00010000C1000C00110C000010001C0C1CC00000001000010C00CCC101001
1001C0C0100C0011C1CC1100CC00000C000000C000100000000C110C00CC000010000CC010000C00C01CC011C00C100C0C1000011000C00CC11C00100C00C111C00C0C0000100000000101
10000CCCC10C100001100CC00C001C0C00C01C00C0000000C00000C0001111001CCCCC0000C1CCC00C110001C0101C1100C1C0011CC00C00C0CC000C0001001C1000C01C0000C00C00C001
1C00000C100000C01C100CC10CC1C00C1C00C0C0C0000001000CC0C00100C0001CC1011010C00000C000C10C000001000C0C000101C0010000CC00001C00010000C00001C0111000101001
1110C0C0CC0000C0CC1C0010C10100000C0C00C010000CCC101C000010000CC000011C010000000000C0000C0C0CC0CC01010000C0C0C00001100C100CC0000C0101CC000C1100110CCC01
110CC01000100011C00C0000C0001C10000C00000001000C0CC00C0C00C1100C0000001C000C00000CC1CC00C0C0CC000C0001C0000CC111101000C000010C01011C001110000C0000C011
1000100010100000CCC0001000CC11000000000C0C011CC0001011C00000C0CC001C0000C00010C11C00010CCCC0C1C0C10C01000010C0000C0000CC0101C00C0100000000000C0000C001
111100C0C00C0000C00C0C0C0CC0C0C100000C101C100C00C00C000CC0000C010000CCC011010111010CCC110CC0C000001C00001001C111C0C0000001CC1000C100C00100CC101C000C01
110C100101000CCC00010CC0C100001000000C00CCCC00000C01C0010C00C00C001CC1000C0011101CCC0010C000100C000CC0001C010000C0C0C0000010000000C1C0000C010C00C00C11
10C0010CC0000C100CCC00001001011C00000001010C000C0C0C1000CC0C000C0C00000C010100000C01C00CCC000C1C01C01C00C0C0000100C0CCC0001C00000000010C000CC000011CC1
1CCC00C0100C0C0C1CC0C010000C0C010C00010C00C00000C00C0C100C0001C000110000C0CC11101000000C011001C10101010100C0000000000C000C00C1C0C0C1000CC000000000C101
1CC000111C0000010110010000100010000000C000001000C010001C011CCCC1C1C1C00C1000C00C1010100011001C00000C1110110010C0C0011CC00CC0C0000C00CC01000000CC01C001
100000C0C1C1001C000C00000C00101C0C0C100100C100C00C100CC000011C01CC01C01000000C0001C00C00C00000C001CC000010C00001000CC0000001000100C00C000C00C000000C11
101C00001001C000000000C1C0100C100000C0C100C000000C0C011001C1000C010C000010000100CCC0011101C1CC0100C01CCC0CCC100C101CC11010C1C0CC000010C0C0000CCC000101
1C0C000C100000C00010101000C0C00000CCCC10C11CC11C0000010CC1110CC1C00000C0C1CC01C00C010010111C00011C0010CC0C0CC100000C00001000011C00000000CC001011C01001
1CC0000000C0C000000CCC10C0C00001000000000C00CC1C010C0001000CCC01000C00000101C01C000010C0C00001C1011C000C10000C0C00100101CC0CCCC0010C010101010C0C1C0001
100CCC10000000C0000C0000CC1C0CC1CCC00000C000C0C0C1C0001CC0000C0010C0000100CC00CC0CC1000C001100000C0010C0000101010C011000C1C00C0CCC0C00101000C000110011
1C0000000000CC001CC0000C10000101C0C110001001CC0000C00000110100100110C011CC0001C0C1000C01C0010C010C1C000000CC00C0CCCC10C000000C0000100CC000000001000C11
10CC1C0000CC01C10000000C100C1CC11C00100CC0001C000000C01C0100C0CC0001000C0000010C00C001000CC0111C000000111C0CC00C0C1C100011C1000000001001C00C0011100C01
11C000C0000011C00C100C000CC0C10C1C0CC00010000010100000010000010010C11C0C00000000C00CC0010C0001C001C0C0001CC1C000000000C001CC0011000CC0000C0001000C0001
1101000CC1CCC10C00C10C00CC0C110C10000C0000000000000C01C000C00001C00C0C000C00100000C0110001110C010C000CCC000000000CC0CC00000C1C0001110CCC0CC0C000010101
1C1100C10C0001C1001C011000000C0010C0C011000001C0000C000100CCC10100101C10C0CC101C00000C0000C0C1010000011000110001C0000000C001C11C000C000C1C00010100CC01
1C00C0110C00C1CCC00000001CC000C00C00000000CC000C0C1C00010000001CC011C0C101001C101C0C10C010C110000C10C1001C0C0C0C00C00001000001C001110C000C1C00CC101101
1C100C01010100000010C011011001C000000CC0CC100CC1C010C01C0C0CC00000CCC0C1C000C0110C00000C001CCC100C0010C01111100000001C01000C10CC0000C0C11000C000000001
1C1C00000000CC000101001CC10CC0110000000C101C00110C010C000C000C0CC1100C0C10C100000100C00000C00C110CC0010C000C1C0C0CC001011C00CCC011CC10C00CC0CCC0010001
10001C001000CCC01C0C0C0000C0000C100C00100C000001011C0C00C001C0C11101C100C00000000C1110C11C000001100000C00100100000C01C010000C00010CC000C100C0C01011CC1
1C11001C00000000010CC0011000C0C0001000C1C0CC0C01100001C0C1100000C0100001CCC10CC01C0C10C0CC011110C0010C00CC101C011C0100CCCC00010000CC1000100010CC0C00C1
10C000CC11C0CC0CCC10C10C0C0CC00C000000100C10C0C00CC10CC0011000100C0C0CCC0C010C0CC10C100C10C00000000CC0000C10CC0C000010CC0C100010101000C0C0000C00010001
1CC1C10C00001000C000C101C000011CC1001C0100000100C0000C0001CCC000000000CC00C11CCC000C00C10CC0C00C0000000000000010000CC0C0CCC0100011C01100000CCCC0C10C01
10CC00010C0000C100C1000C00C0000C000C1011000001C001C111110C01C0C00C0C0001C00100C1000C01C0010110001C0000010CC00000000010CCCC0C0110011C1C0CC0C00C00C1C001
10000C1000101000C00CC0010C100001001C01C01011000C1CC1C000C0000CC001C0C0C00C1CC0C011010000001000000110C00110000C110000000C1C0000011110C0100CC1CC1C000001
10C0C00C0CCC0CC001001C00C0C000001CCCC00000CC0C1010C1000111CC00C01100C00C1CCC0CC000C10C1000011000CC000011C0C10C0C1001C10000C01000101C000100000C00CC0C11
1CCC0C01CC0C00C101CCCC0C0010010C00C0C00001C00000000C00CC0C00CCC0001010C000000CC10CCC000010000C0CC000100110000C0CC0C0000C000CC0100C000000CCCC01C1010C01
1000000100CC0C0100000000C0011C10C1CC0011000C0100C000100000000CC00CC0001010010C00C010CC0C0000C0000CC011C000101C0CC0C00C00000CC1100100CC0CCC0000000C0C01
110000C00CCCCC001010C00CC00CC0100C100C0C10001100C0001C00C101010C0C0C0CC0C011C01C0010C1010CC1001C0000C00010000000C0000CC000000C00011C010000000000CCC011
1000C1C000010110CC0C0000000000000100C010000C1000C00011CC000100CCCC10C10C00C0C00000C11CC00CC00C00100000100100C0011C0C000C10C001C0C00000C0CC0000C0000C01
1000C0100CC10C01C000CC01100001C1C010C0C00011C110001C110C0000CC000C010100000C000000000000C0110C1C0010C00CC10C00C1011000100CCC00C00000000001C00001111C01
1000000C10C0000010000C1CC0000CCCC1000CC00100C1C0C1C00C100000000C00CC0C000C0110010CC0C0000C0C010C00C1C1C1000000C1001100C0000C000C0000C0110C010010CCC001
1000CCCC0C0000C000CC0100001100C0000C01101100CC0001000010000C0C0001000010C0000000C0CCC0C0C1001C00C0010110CCC10C0CCC000C0C0C0001110000000001C0001C100101
10000000CC0C00C0C0CC00101111C10000001C1C00C1001000001CC01001000000C100000C1C0C011C000CC010CC0100C010C0000C00001C10000CC100000001000C00000CC000000001C1
100CC0CC0CC1010CC10010000C000C11000C000010C0101010C0C01CC00000110000C0CC001001C010C0001C00011000C0CC0001001000CCC100CC0100C00000C001C00001C10100000C01
1C0C0001C10C1000C0100C100010110CC01CC00100CC00C100010CC00000C10000C0C0010010010C00010C1000C01101100C00C0101000C000C000C0000100C0000101C0C100CC00000001
10C0C01000C0C00CCC0CC000CC1C0000101100100C0000CCC00101C01100100010000C01C0010000001000C010C00C0C000C000C0100C10000CC00C100000C0C0C000C0C01C10CC0C10011
101000C0C0001C000C000C0001C00C0000000110100CC0C0C010C0C000C00C0C10C0C0C1C00C10CC000001011C0CC0C10C100000CC1C0010C010C000CC001000C000C0010010100C11CCC1
1CC0001C100C101C010001000000CC010C0C000C0C00000C00CCC10000000C011C110C11C001100C1100C00C101CCC01000000C0C000C00011C1C10000011000C101000C0C00000C1C10C1
100110110000011100001110010001011CC0C001C1C00001C0100CC1011C011CC100010C1C10C00C00010100000CC00C0C01CC101010111000010C00C00010110100C0C0C00C0C011C00C1
11C01000101C0000C1C0010101C0100C000000C01100C1CC00C0000C0C110101011000C10C01000C0C00C01000000CCC1C1C0000CCC11C10000C00100CC01CCC0C1CC1CC01010011C00001
100C0000C0C001C0100100C00C100C0CC0CC0C01C0101100CC00101001000C000C0C0C10C01100000CCCC10001CC010C0CC00CC000C1C010CC010100C100C000001CC00C010C0C0C0010C1
100C001C0110CC0C100C000C0C001010C000001000CCCC00101C00000C0C1011C100100010C001001110C001001000C00100000000C00001001CCC1C0C0000C11C01110C00010CC0C00C01
1C10100CC00C000CC10CCCC001CC000100001000CC00C000C00C001CCC0000CC00CC000C0111C00CC000100100CC0C01CC001010000CC0C00C0101001001C0000C1010000CC100C0CCCCC1
1000C0C1CC000010C0C00001C0CC00110000C00000000000CC10C01C0CC000C00C00C00C1C11C01100C0000010000010000C00C1001C00C0011C01001010010C0000000CC00C0C0C000001
1CC0C1001CCC011C1000010000110CC111C0000100C10CC00CC00CC010010010111C0C000000C00100C10000000C1001CC000000C1C100C000C001CCC00CC001C1000100C00110CC0C00C1
1C1C010000001100CCC000001C0C0CC1CC011100000001C000000000C10C000CCC00000CC0000C1C00000C0000C10C00001000C1000000C001000000000C01C10001000000C0001CC0C001
1C0C10C01C0C110C0C00C00101000C0001000C000C10C0000CC0CCC0C10000C0000100CCC0C1C1CC01000C000C1010C01111000010C00001000000CC010C010C0C01101001C11C001010C1
11C0C10C00CCCC0C0001C01C100000C0010C0CC0110001C000CC10010000C0000001C000C000CC1C000C00000010000000CC0100001CC0C00C010100010C00C00C10C0C000000101C0C001
1CCC0010C0C1C01000C000001CC1001100000000C000000010CC0C0C001000110C00C0CC100000CCCC0CC100000010000100000C01C1001100C01C0CC00C1C0000C0000001010010011011
10C11CC000010C00100C0C0C00100C0101100C01C00C0100C0CCC0C10C00010111001C011C0101001CC0C00C000CCCC00010CC1C0001C1000C0000CC0C001000C01C0C1C000001101C0101
10C0000000000100010CC1C01CC100C000C01100C0000C10000000C001CC000000C1000010110100100C0000C0CC11000111C001CC01C000000C00000C0C00C000C0010C00000C0C110001
10C01C100C10001C0000100C100000C0010C1011100C10100CC000CC000C0101C000111C0CCC01C0C0C00000000C00001C00000110C01C00000C1CCCC1C0010100100011C0010000001001
1001000100CC010C00C00000000C000010C000CC0000000C000C010CC000C0000C0C00010000000001C11C100CCC010C00000C00100C0010111000100010011C00CC0000C01C0CC00000C1
100CC00C000C0C10C0100100C0000C00010C00000100010010101C0C010000000000CC0001C10000C01000000CC00CC000001C0000C00000000011C00C011CC0C000C100C0111101C01CC1
11C110011000C0000000C011C01100100100CC011C0101110C0000C000C101000CCC100C1000010C0000000000000C00000C0001C0010CC0C0C000010000011101CC0C000100C000010101
101C0C00C00001CCC000CCC1C01000111CC00C010C000C1000C0C0C1000C0CCC1100CC01000CC000C00001C110C1000011C10C100C000000000000000CC10000C0C0101C000001C10C10C1
1000C101100C0000C0C000100101001CCC1000010000C001000C001CC0CC1C0010C1C10C00100000000000011CCC0C010000C0000010C0100CC0100011CC110000010001000C011100C101
110C00C001C100110C00C00C001C00000C00CC0010C000000C00C00C000000C0C110C101100C100C0010010C00C01CC11000C00010000C1000000C101CC01001110C0C00000110C001C011
1101000CCC0000001C000111010C0C0C011010110100C00C11CCC00C10000001010000CC0C0C11011C00000001010C0000C1C000C0C1100000C01CC0000100C100CC0CC00C00CC00CC00C1
1C1000100C100C00C00C0CCC0000C0100000C000C0000000100C000010C0CCCC1C000C101C0C0C10100000010000CC001CCC01C1010100C100C00C010C1C0C0C00C00000000C0C0C0C1001
101000C0C000C000C0C000000CC00C11CC0001010CC010C000001001CC00C0C00C00C0CCC0CC0C100000C0C100CC1C10C10C000100000011C0C00C1C1010001CCC10C110110000C100C101
100001C00100C00001C0CCC0CC10000000C1C00CC0000000C01000001000C0100000CC1C001CCC001011000000010C11C00C00000000C00100C0C0C000C000C0C1000000C0C1C0CC0C0C11
1100C00C100C01100000000C0011100000011001010C010CCC00000CC0000C10C000C000000CC00C0010010000C1100CCCC000C00C00100000100101001C110011C111000C000010000101
1000100CC0000100C0C01CCC001001100001000C00000000CC011000010C0010110110C0000C001110CC0000C0C0C00011C0C1C1C000C0C1CC11000C00100CCC010000CC0C00CC000C0101
10C0C0110000000000C001000C11CC10110C000CC0000100C0011001000C0C0CC1CC000C011101CC0C000000C1010CCC01C000C111000C010C0000CC10CC00C1C0000001C0C00C01000CC1
1001C1101101C1001C00C0CCC0C00CC01C010CCC00C0001000C10C0010C100000C0C00000000C010C1001C0CC10000000001C000C00CC100C00C11110C100C0100000100CC010100CC0001
1CC00011CC00000C0001CC11000001CC000000011C00C1C00011C01C010000C10CCC1C0001100C0C00C10C000C00000C00C100C01C1011C100C100100000C000C01000C000C10C00C01001
110C0C00000CC000C111C000100001CCC1C0001C001C00010CC11C1CC0CCC0010010001000000001CC000C01101CC00000000CC01010000C1001000011000001110CCC010C000000000C01
111111111111111111111111111111111111111111111111111111111111111111111111111111111111111111111111111111111111111111111111111111111111111111111111111111
