11111111111111111111111111111111111111111111111111
10000CP00010000111000000010010000F1001F10100010001
1F1001100F0100000000F000010F0110011010011F00F10001
101111F01F00101010010000F100F110F00000011101000001
11110111FF00010F11010000F110000000011000001001F001
1000100101F0000010010000100F00FF100F100100100110F1
10F010F100101FF100000F0001000010FF0101000F01010001
1F000000110F1000100F0F1FF01010001001011F1010F00F01
1F001001000F10000F10F10001100101001F0000010001F011
1F001F1F1011000F0F0011010F0000000F100F100000000F01
1001111F0000000010100011000000010100000FF101010001
11F00F000100F01001001F00100F0001110001100100100001
1100100001100011001000000001100F00100000F101001011
10000000001F00010000F000011100FF000001100001101001
100001100001010010001F1100000F01F10F00010000011001
1100F0011111100FF000000F0F101011100001010111100101
100100F01001111F0001101000010011001011F0001F110001
10011001100000F01001101000FF1000110001001100010101
110000100110010F011FF101F10110F110000F0F1101000001
1010001F1F00010100000001110F0000F1110000F0F0011111
1101F10F00F0010110010001100110100001F11F00F1110101
1000011100000F1001001110F0F00010F01110010011111011
100F000011F0011100F10F1F1F0F0010000000000001101001
11000110011011000F01100001000010101F010000001F0111
11F0100000101010000001F1F01F10111010F00101F01000F1
10F0FF00100010001000010100F010000110101010010F0F01
101010000FF101000110100010F01001000000100100011111
1F011F01011F100010001100010000000001000001F1000011
1000000100000011000F010010000010FF001101010F0101F1
10010010000000100011100111000110001000F0010000F101
1F1001010101001010011101F01000F000F000000100010001
100000101F00F01001000011F000010F0100001F1001100111
1F10100001000000000000F001F01011010111110100000FF1
101110011010000000011F1010000010000100100010001011
100F01100000100110F0000000FF11F10100100F00F0F00F11
10110F100111100100011100F011100F010110100110000001
1FF01011000000101111111110F010F1001F0000001000F001
110000100101000F0100111100F01110000F0000F00F10F001
1000F10F0F10000F11010F010F000F1110F000100100101001
11010000110F010010001F0F0011111100001111F010000111
10F0000F111000101000F000F01011000010110001011FF011
1010F1001F101F00000111F0F1111110001F00000000011F11
100010000000011000010F00010111F101F0001001100F0001
110010F1100000000000000010010000001111000F10010011
10000F00111F10000F1F11F0F11010001001100101FF010001
10000100001F10010010101001F000F00F010010000001F011
1F11FF1001F0000011110F0010000F11010010001110011001
11100110000000FF1001101F01F0011000110F10000F01F101
110FF00FF0F0F1001010001011010000010F010000000E0111
11111111111111111111111111111111111111111111111111
